+---+---+---+---+---+
|   |               |
+   +   +---+   +   +
|   |       |   |   |
+   +---+---+   +   +
|   |           |   |
+   +   +---+---+   +
|       |       |   |
+---+---+   +---+   +
|                   |
+---+---+---+---+---+